X 2 2 0 1
A 3 3 0 1
B 2 4 0 0
C 2 4 1 0
D 2 4 2 0
E 2 1 2 0
F 3 1 4 0
G 2 2 5 0
H 2 4 4 1
I 2 5 4 1