X 2 2 1 1
A 2 0 0 1
B 2 2 0 0
C 2 4 0 1
D 2 5 0 1
E 3 3 2 0
F 3 0 3 0
G 2 3 3 1
H 2 0 4 0
I 2 0 5 0
L 3 2 5 0