X 2 2 2 1
A 2 0 0 1
B 2 1 0 0
C 2 4 0 1
D 2 0 2 0
E 3 4 2 1
F 3 1 3 1
G 2 2 4 0
H 2 4 5 0